11111111111111111111111111111111111111111111111111111111111111111
100000C00C000C0C00000000000C00C0000CC00000C000000000C00C0C0000001
10000000C0000000000000C0000000000C0C0000000000C0000000000000C0C01
10C000C0CCCC0000C0CC000CC0C00000C00C0CC0000000C0000CC0000000000C1
100000C000C000000000000C00000000C00CC0CC00C000000000000000000C001
100C0C000000CC0000C00000C0C00C0000C0C0000C00CC0C00000C0C000000001
1C00000C0000000000000C00000C0C00C00000C00000000C0C00000C000C00001
1000000000C00ECC0CC00CCC00000000C00000000C0CC000C0000000000000001
1000C0C0C00000000000000000C00C00C000000000C0000000C0C0C0CC00000C1
10000000000000C00000000000000000C000000C00000000000000C000C000C01
1CC0C000000CCCC0C00000000000000000000000000000000000000C0C0C00001
100000000000C0C0000000C0C0C00000000000C0C0C0C000000CC000000C00C01
100CC0000000C0000000000C00C00000000C0C000C0000C000000000000000C01
1C000000C000000000000CC0C0C000000C00C00C000000C000000000000C0C001
1C000000000CC000CCC00000C00000C000C0C0000CC0000000000C000CC0C0001
100C000C00CC0C000000000000C00000C000000C00000C000000000C0000000C1
1CC00C000000CC00000C000000C00C000P00000000C0000CCC00C000000000001
1C0C0000000CC0C0000C0000C0000000C000C000000000000000C0000C0C00CC1
100000000C00C000C000000000C0CC000000C00000000000CC000000C00000001
1000000C000000000000000000000000C000000000C0C0000C0000C000CCC00C1
100C000000000000CC00000CC0C0000CC000000CCC0000C000000000000000001
1C00C0000000C000C0000000000000000C00C00C0000C000C0000000000C0C001
1C000C000000000000000000CCC0000000000C000000C0000C000000000000C01
1000000000CC00000000C0000000000C000CCC00C0C00000000C00000C0C00001
10C0C000C00C0000C0C000C0C0000C000000000CC0000C000C0000000000C0001
1000000C00CC0000000000C00000C000000000CC0000CC00C00C000CC0C0C0CC1
10000C0000000000C00C00000C0000000C0C0000CC00C00CC000000000000C001
100C00C000C0C000000000CC000000C0C00000000000000C00000000C00000001
100C00000C000C00C0000000000000000000C0CCC00C00C000000C00000000C01
1000C0C0C0000000C00000C00C000000000CC00C000C0C0C000C0000000000C01
10CC00C0C000000C00CC0000000C0000000000C000C00000CC0000000CC000C01
1CCCC0C0000000000000000000000000000CC000000000000C00C0000000C0C01
10CC00000000C00000C000C000000000000C00CC00000000C00000C00CC000C01
1C00000C0000000CC00000000000000C00000000000000C000000000000000001
11111111111111111111111111111111111111111111111111111111111111111

