1111111111111111111111111111111111
1000000000000000000000000000000001
1110010100100000101001000000010101
1E10010010111010001001000000010101
1P000000000C1000000000000000000001
1111111111111111111111111111111111