111111111111111111111111111111111111
1000000000C0000000CC0C000000000000C1
100000000C00C00000C0C00000C0CC000001
100000CCC0000C00000000000ECC00000001
1000C00C00C0C00000CC00000C0CCC000001
10000C000000000C0000000C000C0000C001
10000C000000000000C0C0000C0000000001
10C00000C000CCC000C00C0C000000000C01
100C0000C00C000000000CC00CCC00000001
1000000C0CC0C00C0C0000000CC000000001
10CCC0CC0000CPC00000CC00C00000000C01
1C00000000000C0C0000C0C00C0C00C00001
10000CC00000000000CC00C000000C000C01
10000C00000000C0C00000000000000000C1
10CC000C000000000000000000C0C0CC0001
1C0C0C0000000C00C0000C000000C0000C01
1C000000000C0000C000C0C00000C00C0001
10000000000C00CC0000000000000000C001
1C000000000000000000000000000000C001
100000000000C00C0C00000000C000C00001
10C000000000000000000CC0C00000000C01
1000000CC000C000000000C000000000C001
1C00CC000000000C0000C0C000C0C0C0C001
100000C0000000000000C0C0C00000000C01
100000000C000000C000CC0000000C00CC01
100CC0000C00000000C0000C00C00000C001
1000C0000C0000000CC0C00C00000000C001
1000C00C0000000000000C00C000000C0001
1C000CC00C00C00000000CC00C0000000001
10C00000000000000C00000000C000000001
1000000000C000000C0000000000000C0001
1CC00C0C00000C0000C0C0CC0CC0000C0001
100000C000000000000C00000C0000000001
10000000C0C00000C00000C000CC00C00C01
111111111111111111111111111111111111