111111111
1ECP11111
111111111
111111111