1111111111
1P0C00E001
1111111111