1111111111111111111111111111111111
1EP0000000000000000000000C00000001
1111111111111111111111111111111111